{
  "col": 8,
  "row": 9,
  "tint": 10336737,
  "boxes": [
    {"x": 6, "y": 3}
  ],
  "role": {"x": 4, "y": 3},
  "subs": [
    {
      "row": 3,
      "col": 3,
      "x": 5,
      "y": 3,
      "layout": [
        1, 1, 1,
        0, 0, 0,
        1, 1, 1
      ]
    }
  ],
  "layout": [
    1, 1, 1, 1, 1, 1, 1, 1,
    1, 1, 1, 1, 1, 1, 0, 1,
    1, 1, 1, 1, 1, 1, 0, 1,
    1, 0, 0, 0, 0, 0, 0, 1,
    1, 0, 0, 1, 1, 1, 0, 1,
    1, 1, 0, 1, 1, 1, 0, 1,
    1, 0, 0, 1, 0, 0, 0, 1,
    1, 0, 0, 1, 1, 1, 1, 1,
    1, 1, 1, 1, 1, 1, 1, 1
  ]
}
