{
  "col": 11,
  "row": 9,
  "tint": 6815608,
  "layout": [
    1, 1, 1, 1, 1, 1, 1, 1, 1, 1, 1,
    1, 1, 0, 0, 0, 1, 1, 0, 1, 1, 1,
    1, 1, 0, 0, 0, 1, 1, 0, 0, 1, 1,
    1, 1, 0, 0, 0, 1, 0, 0, 0, 1, 1,
    1, 0, 0, 0, 0, 1, 1, 0, 1, 1, 1,
    1, 1, 1, 1, 0, 1, 1, 0, 0, 0, 1,
    1, 1, 1, 0, 0, 0, 0, 0, 1, 0, 1,
    1, 1, 1, 1, 1, 1, 1, 0, 0, 0, 1,
    1, 1, 1, 1, 1, 1, 1, 1, 1, 1, 1
  ]
}
