{
  "col": 9,
  "row": 9,
  "tint": 4634879,
  "layout": [
    1, 1, 1, 1, 1, 1, 1, 1, 1,
    1, 1, 1, 1, 1, 0, 0, 0, 1,
    1, 0, 0, 0, 1, 1, 0, 1, 1,
    1, 0, 0, 0, 1, 1, 0, 1, 1,
    0, 0, 0, 0, 1, 1, 0, 1, 1,
    1, 0, 0, 0, 0, 0, 0, 1, 1,
    1, 0, 0, 0, 1, 1, 0, 1, 1,
    1, 0, 0, 0, 0, 1, 1, 1, 1,
    1, 1, 1, 1, 0, 1, 1, 1, 1
  ]
}
